FK Sarajevo	Bosnia & Herzegovina
FK Borac Banja Luka	Bosnia & Herzegovina
HSK Zrinjski Mostar	Bosnia & Herzegovina
NK Siroki Brijeg	Bosnia & Herzegovina
FK Velez Mostar	Bosnia & Herzegovina
FK Zeljeznicar Sarajevo	Bosnia & Herzegovina
FK Sloboda Tuzla	Bosnia & Herzegovina
FK Mladost Doboj-Kakanj	Bosnia & Herzegovina
FK Tuzla City	Bosnia & Herzegovina
FK Krupa na Vrbasu	Bosnia & Herzegovina
FK Radnik Bijeljina	Bosnia & Herzegovina
FK Olimpik Sarajevo	Bosnia & Herzegovina
GNK Dinamo Zagreb	Croatia
HNK Hajduk Split	Croatia
NK Osijek	Croatia
HNK Rijeka	Croatia
HNK Gorica	Croatia
NK Lokomotiva Zagreb	Croatia
NK Varazdin	Croatia
HNK Sibenik	Croatia
NK Istra 1961	Croatia
Slaven Belupo Koprivnica	Croatia
Red Star Belgrade	Serbia
FK Partizan Belgrade	Serbia
FK Cukaricki	Serbia
FK Vojvodina Novi Sad	Serbia
FK TSC Backa Topola	Serbia
FK Spartak Subotica	Serbia
FK Vozdovac	Serbia
FK Radnik Surdulica	Serbia
FK Metalac Gornji Milanovac	Serbia
FK Radnicki Nis	Serbia
FK Proleter Novi Sad	Serbia
FK Napredak Krusevac	Serbia
FK Indjija	Serbia
FK Novi Pazar	Serbia
FK Mladost Lucani	Serbia
FK Javor-Matis Ivanjica	Serbia
FK Zlatibor Cajetina	Serbia
FK Rad	Serbia
OFK Backa	Serbia
FK Macva Sabac	Serbia
NK Maribor	Slovenia
NK Olimpija Ljubljana	Slovenia
NK Celje	Slovenia
NS Mura	Slovenia
NK Domzale	Slovenia
NK Bravo	Slovenia
NK Aluminij Kidricevo	Slovenia
NK Tabor Sezana	Slovenia
FC Koper	Slovenia
ND Gorica	Slovenia
Ferencvárosi TC	Hungary
MOL Fehérvár FC	Hungary
Puskás Akadémia FC	Hungary
MTK Budapest	Hungary
Budapest Honvéd FC	Hungary
Újpest FC	Hungary
Mezőkövesd Zsóry FC	Hungary
Kisvárda FC	Hungary
Diósgyőri VTK	Hungary
Paksi FC	Hungary
Zalaegerszegi TE FC	Hungary
Budafoki MTE	Hungary
Club Brugge KV	Belgium
KRC Genk	Belgium
RSC Anderlecht	Belgium
Standard Liège	Belgium
KAA Gent	Belgium
Royal Antwerp FC	Belgium
RSC Charleroi	Belgium
Cercle Brugge	Belgium
KV Oostende	Belgium
Oud-Heverlee Leuven	Belgium
KV Mechelen	Belgium
KV Kortrijk	Belgium
Beerschot V.A.	Belgium
Sint-Truidense VV	Belgium
SV Zulte Waregem	Belgium
KAS Eupen	Belgium
Waasland-Beveren	Belgium
Royal Excel Mouscron (-2022)	Belgium
FC Progrès Niederkorn	Luxembourg
Union Titus Petange	Luxembourg
Swift Hesperange	Luxembourg
F91 Dudelange	Luxembourg
Jeunesse Esch	Luxembourg
Racing FC Union Luxembourg	Luxembourg
FC Differdange 03	Luxembourg
CS Fola Esch	Luxembourg
FC UNA Strassen	Luxembourg
FC Wiltz 71	Luxembourg
US Mondorf-Les-Bains	Luxembourg
FC Victoria Rosport	Luxembourg
FC Rodange 91	Luxembourg
US Hostert	Luxembourg
FC Etzella Ettelbruck	Luxembourg
FC RM Hamm Benfica	Luxembourg
BSC Young Boys	Switzerland
FC Basel 1893	Switzerland
FC St. Gallen 1879	Switzerland
FC Zürich	Switzerland
FC Lausanne-Sport	Switzerland
Servette FC	Switzerland
FC Luzern	Switzerland
FC Lugano	Switzerland
FC Sion	Switzerland
FC Vaduz	Switzerland
Red Bull Salzburg	Austria
Rapid Vienna	Austria
LASK	Austria
SK Sturm Graz	Austria
Austria Vienna	Austria
Wolfsberger AC	Austria
WSG Tirol	Austria
SKN St. Pölten	Austria
FC Admira Wacker Mödling	Austria
SCR Altach	Austria
TSV Hartberg	Austria
SV Ried	Austria
SK Slavia Prague	Czech Republic
AC Sparta Prague	Czech Republic
FC Viktoria Plzen	Czech Republic
FC Slovan Liberec	Czech Republic
FK Mlada Boleslav	Czech Republic
FC Banik Ostrava	Czech Republic
FK Jablonec	Czech Republic
SK Sigma Olomouc	Czech Republic
MFK Karvina	Czech Republic
Bohemians Prague 1905	Czech Republic
1.FC Slovacko	Czech Republic
SK Dynamo Ceske Budejovice	Czech Republic
FK Teplice	Czech Republic
FC Zbrojovka Brno	Czech Republic
FK Pardubice	Czech Republic
FC Fastav Zlin	Czech Republic
1.FK Pribram	Czech Republic
Slezsky FC Opava	Czech Republic
Lech Poznan	Poland
Legia Warszawa	Poland
Rakow Czestochowa	Poland
Pogon Szczecin	Poland
Jagiellonia Bialystok	Poland
Cracovia	Poland
Górnik Zabrze	Poland
Zaglebie Lubin	Poland
Wisla Kraków	Poland
Lechia Gdansk	Poland
Piast Gliwice	Poland
Wisla Plock	Poland
Slask Wroclaw	Poland
Warta Poznan	Poland
Stal Mielec	Poland
Podbeskidzie Bielsko-Biala	Poland
Paris Saint-Germain	France
Olympique Lyon	France
AS Monaco	France
LOSC Lille	France
Stade Rennais FC	France
Olympique Marseille	France
OGC Nice	France
AS Saint-Étienne	France
Montpellier HSC	France
Angers SCO	France
RC Strasbourg Alsace	France
FC Girondins Bordeaux	France
Stade Reims	France
RC Lens	France
FC Metz	France
Stade Brestois 29	France
FC Nantes	France
FC Lorient	France
Dijon FCO	France
Nîmes Olympique	France
Ajax Amsterdam	Netherlands
PSV Eindhoven	Netherlands
AZ Alkmaar	Netherlands
Feyenoord Rotterdam	Netherlands
FC Utrecht	Netherlands
FC Groningen	Netherlands
Vitesse Arnhem	Netherlands
SC Heerenveen	Netherlands
Twente Enschede FC	Netherlands
Willem II Tilburg	Netherlands
Fortuna Sittard	Netherlands
PEC Zwolle	Netherlands
Heracles Almelo	Netherlands
Sparta Rotterdam	Netherlands
ADO Den Haag	Netherlands
FC Emmen	Netherlands
VVV-Venlo	Netherlands
RKC Waalwijk	Netherlands
FCSB	Romania
Universitatea Craiova	Romania
CFR Cluj	Romania
FC Viitorul Constanta	Romania
Astra Giurgiu	Romania
FC Dinamo 1948	Romania
FC Botosani	Romania
Sepsi OSK Sf. Gheorghe	Romania
FC Voluntari	Romania
Academica Clinceni	Romania
FC Hermannstadt	Romania
UTA Arad	Romania
Gaz Metan Medias	Romania
AFC Chindia Targoviste	Romania
ACSC FC Arges	Romania
ACSM Politehnica Iasi	Romania
Bayern Munich	Germany
Borussia Dortmund	Germany
RB Leipzig	Germany
Bayer 04 Leverkusen	Germany
Borussia Mönchengladbach	Germany
Eintracht Frankfurt	Germany
VfL Wolfsburg	Germany
Hertha BSC	Germany
TSG 1899 Hoffenheim	Germany
VfB Stuttgart	Germany
1.FSV Mainz 05	Germany
SC Freiburg	Germany
FC Schalke 04	Germany
1. FC Köln	Germany
SV Werder Bremen	Germany
FC Augsburg	Germany
1.FC Union Berlin	Germany
Arminia Bielefeld	Germany
SL Benfica	Portugal
FC Porto	Portugal
Sporting CP	Portugal
SC Braga	Portugal
FC Famalicão	Portugal
Vitória Guimarães SC	Portugal
Boavista FC	Portugal
Rio Ave FC	Portugal
FC Paços de Ferreira	Portugal
Portimonense SC	Portugal
CS Marítimo	Portugal
CD Santa Clara	Portugal
Moreirense FC	Portugal
SC Farense	Portugal
Belenenses SAD	Portugal
Gil Vicente FC	Portugal
CD Tondela	Portugal
CD Nacional	Portugal
FC Barcelona	Spain
Real Madrid	Spain
Atlético de Madrid	Spain
Sevilla FC	Spain
Real Sociedad	Spain
Villarreal CF	Spain
Valencia CF	Spain
Real Betis Balompié	Spain
Athletic Bilbao	Spain
Getafe CF	Spain
Celta de Vigo	Spain
Granada CF	Spain
Levante UD	Spain
CA Osasuna	Spain
SD Eibar	Spain
Deportivo Alavés	Spain
SD Huesca	Spain
Real Valladolid CF	Spain
Cádiz CF	Spain
Elche CF	Spain
Inter Milan	Italy
Juventus FC	Italy
AC Milan	Italy
SSC Napoli	Italy
Atalanta BC	Italy
AS Roma	Italy
SS Lazio	Italy
ACF Fiorentina	Italy
US Sassuolo	Italy
Cagliari Calcio	Italy
Torino FC	Italy
Udinese Calcio	Italy
Hellas Verona	Italy
Bologna FC 1909	Italy
Parma Calcio 1913	Italy
UC Sampdoria	Italy
Genoa CFC	Italy
Spezia Calcio	Italy
FC Crotone	Italy
Benevento Calcio	Italy
Olympiacos Piraeus	Greece
PAOK Thessaloniki	Greece
AEK Athens	Greece
Panathinaikos Athens	Greece
Aris Thessaloniki	Greece
OFI Crete FC	Greece
Atromitos Athen	Greece
AE Larisa	Greece
Volos NPS	Greece
Asteras Tripolis	Greece
Panetolikos GFS	Greece
PAS Lamia 1964	Greece
PAS Giannina	Greece
Apollon Smyrnis	Greece
Maccabi Tel Aviv	Israel
Maccabi Haifa	Israel
Hapoel Beer Sheva	Israel
Beitar Jerusalem	Israel
Maccabi Petah Tikva	Israel
FC Ashdod	Israel
Hapoel Tel Aviv	Israel
Maccabi Netanya	Israel
Hapoel Hadera	Israel
Bnei Yehuda Tel Aviv	Israel
Hapoel Haifa	Israel
Ihud Bnei Sakhnin	Israel
Ironi Kiryat Shmona	Israel
Hapoel Kfar Saba	Israel
Ludogorets Razgrad	Bulgaria
CSKA-Sofia	Bulgaria
Levski Sofia	Bulgaria
Botev Plovdiv	Bulgaria
Lokomotiv Plovdiv	Bulgaria
Arda Kardzhali	Bulgaria
Slavia Sofia	Bulgaria
CSKA 1948	Bulgaria
Cherno More Varna	Bulgaria
Beroe Stara Zagora	Bulgaria
Tsarsko Selo (- 2022)	Bulgaria
Botev Vratsa	Bulgaria
Etar Veliko Tarnovo	Bulgaria
Montana	Bulgaria
Shakhtar Donetsk	Ukraine
Dynamo Kyiv	Ukraine
Zorya Lugansk	Ukraine
Desna Chernigiv	Ukraine
Vorskla Poltava	Ukraine
FK Mariupol	Ukraine
SK Dnipro-1	Ukraine
Kolos Kovalivka	Ukraine
FK Oleksandriya	Ukraine
Rukh Lviv	Ukraine
PFC Lviv	Ukraine
Olimpik Donetsk	Ukraine
Ingulets Petrove	Ukraine
FK Minaj	Ukraine
Fenerbahce SK	Türkiye
Galatasaray A.S.	Türkiye
Besiktas JK	Türkiye
Trabzonspor	Türkiye
Istanbul Basaksehir FK	Türkiye
Alanyaspor	Türkiye
Kasimpasa	Türkiye
Fatih Karagümrük	Türkiye
Göztepe	Türkiye
Hatayspor	Türkiye
Sivasspor	Türkiye
Caykur Rizespor	Türkiye
Antalyaspor	Türkiye
Konyaspor	Türkiye
Yeni Malatyaspor	Türkiye
Gaziantep FK	Türkiye
Kayserispor	Türkiye
MKE Ankaragücü	Türkiye
Genclerbirligi Ankara	Türkiye
Büyüksehir Belediye Erzurumspor	Türkiye
Denizlispor	Türkiye
Zenit St. Petersburg	Russia
Spartak Moscow	Russia
CSKA Moscow	Russia
Lokomotiv Moscow	Russia
FK Krasnodar	Russia
Rubin Kazan	Russia
Dynamo Moscow	Russia
FK Rostov	Russia
FC Sochi	Russia
Arsenal Tula	Russia
Akhmat Grozny	Russia
FK Khimki	Russia
Ural Yekaterinburg	Russia
FK Ufa	Russia
Rotor Volgograd	Russia
PFK Tambov	Russia
FC Midtjylland	Denmark
FC Copenhagen	Denmark
FC Nordsjaelland	Denmark
Bröndby IF	Denmark
Aarhus GF	Denmark
Vejle Boldklub	Denmark
Aalborg BK	Denmark
SönderjyskE	Denmark
Odense Boldklub	Denmark
Randers FC	Denmark
AC Horsens	Denmark
Lyngby BK	Denmark
Malmö FF	Sweden
IFK Göteborg	Sweden
Hammarby IF	Sweden
Djurgårdens IF	Sweden
AIK Solna	Sweden
BK Häcken	Sweden
IFK Norrköping	Sweden
Örebro SK	Sweden
IF Elfsborg	Sweden
Kalmar FF	Sweden
IK Sirius	Sweden
Östersunds FK	Sweden
Mjällby AIF	Sweden
Degerfors IF	Sweden
Halmstads BK	Sweden
Varbergs BoIS	Sweden
Glentoran FC	Northern Ireland
Glenavon FC	Northern Ireland
Linfield FC	Northern Ireland
Crusaders FC	Northern Ireland
Larne FC	Northern Ireland
Cliftonville FC	Northern Ireland
Coleraine FC	Northern Ireland
Ballymena United	Northern Ireland
Dungannon Swifts	Northern Ireland
Warrenpoint Town FC	Northern Ireland
Portadown FC	Northern Ireland
Carrick Rangers	Northern Ireland
Dundalk FC	Ireland
Shamrock Rovers	Ireland
Waterford FC	Ireland
Derry City	Ireland
Sligo Rovers	Ireland
St. Patrick's Athletic	Ireland
Finn Harps	Ireland
Drogheda United FC	Ireland
Bohemian Football Club	Ireland
Longford Town FC	Ireland
Manchester City	England
Liverpool FC	England
Chelsea FC	England
Manchester United	England
Tottenham Hotspur	England
Arsenal FC	England
Everton FC	England
Leicester City	England
Wolverhampton Wanderers	England
Aston Villa	England
West Ham United	England
Brighton & Hove Albion	England
Southampton FC	England
Newcastle United	England
Fulham FC	England
Leeds United	England
Crystal Palace	England
Sheffield United	England
West Bromwich Albion	England
Burnley FC	England
Celtic FC	Scotland
Rangers FC	Scotland
Hibernian FC	Scotland
Aberdeen FC	Scotland
Motherwell FC	Scotland
Livingston FC	Scotland
Dundee United FC	Scotland
St. Johnstone FC	Scotland
Ross County FC	Scotland
St. Mirren FC	Scotland
Kilmarnock FC	Scotland
Hamilton Academical FC	Scotland
Fylkir Reykjavík	Iceland
KA Akureyri	Iceland
Valur Reykjavík	Iceland
KR Reykjavík	Iceland
Breidablik Kópavogur	Iceland
FH Hafnarfjördur	Iceland
Stjarnan Gardabaer	Iceland
Víkingur Reykjavík	Iceland
ÍA Akranes	Iceland
HK Kópavogs	Iceland
Leiknir Reykjavík	Iceland
Keflavík ÍF	Iceland
Kuopion Palloseura	Finland
HJK Helsinki	Finland
Ilves Tampere	Finland
SJK Seinäjoki	Finland
FC Inter Turku	Finland
IFK Mariehamn	Finland
FC Honka	Finland
Helsinki IFK	Finland
FC Lahti	Finland
FC KTP	Finland
AC Oulu	Finland
FC Haka	Finland
Rosenborg BK	Norway
Molde FK	Norway
SK Brann	Norway
FK Bodø/Glimt	Norway
Sarpsborg 08 FF	Norway
Stabæk Fotball	Norway
Viking Stavanger	Norway
Vålerenga Fotball	Norway
Lillestrøm SK	Norway
FK Haugesund	Norway
Strømsgodset IF	Norway
Kristiansund BK	Norway
Odds BK	Norway
Tromsø IL	Norway
Sandefjord Fotball	Norway
Mjøndalen IF	Norway
FK Kukësi	Albania
FK Partizani	Albania
KF Tirana	Albania
KF Laçi	Albania
KF Vllaznia	Albania
KF Bylis Ballsh	Albania
KF Teuta	Albania
KF Skënderbeu	Albania
FK Apolonia	Albania
KS Kastrioti	Albania
APOEL Nicosia	Cyprus
Apollon Limassol	Cyprus
Omonia Nicosia	Cyprus
Anorthosis Famagusta	Cyprus
AEL Limassol	Cyprus
Pafos FC	Cyprus
AEK Larnaca	Cyprus
Olympiakos Nicosia	Cyprus
Ermis Aradippou	Cyprus
Nea Salamina Famagusta	Cyprus
Ethnikos Achnas	Cyprus
Doxa Katokopias	Cyprus
Enosis Neon Paralimniou	Cyprus
Karmiotissa Pano Polemidion	Cyprus
FCI Levadia	Estonia
FC Flora Tallinn	Estonia
Paide Linnameeskond	Estonia
Kalju FC	Estonia
JK Trans Narva	Estonia
Jalgpallikool Tammeka	Estonia
JK Viljandi Tulevik	Estonia
Tallinn JK Legion	Estonia
FC Kuressaare	Estonia
Pärnu JK Vaprus	Estonia
BATE Borisov	Belarus
Shakhter Soligorsk	Belarus
Dynamo Brest	Belarus
Dinamo Minsk	Belarus
Rukh Brest (- 2022)	Belarus
FK Minsk	Belarus
Neman Grodno	Belarus
Slavia Mozyr	Belarus
Isloch Minsk Region	Belarus
Energetik-BGU Minsk	Belarus
Torpedo-BelAZ Zhodino	Belarus
FK Vitebsk	Belarus
FK Gomel	Belarus
FK Slutsk	Belarus
FK Smorgon	Belarus
Sputnik Rechitsa (- 2021)	Belarus
Slovan Bratislava	Slovakia
DAC Dunajska Streda	Slovakia
AS Trencin	Slovakia
MSK Zilina	Slovakia
Spartak Trnava	Slovakia
Orion Tip Sered	Slovakia
FC Nitra	Slovakia
MFK Ruzomberok	Slovakia
FK Senica	Slovakia
Zemplin Michalovce	Slovakia
FK Pohronie	Slovakia
ViOn Zlate Moravce-Vrable	Slovakia
Riga FC	Latvia
FK Liepaja	Latvia
FK RFS	Latvia
FK Ventspils	Latvia
FC Noah Jurmala	Latvia
Valmiera FC	Latvia
Spartaks Jurmala	Latvia
BFC Daugavpils	Latvia
FK Metta	Latvia
FK Suduva Marijampole	Lithuania
FK Zalgiris Vilnius	Lithuania
FK Panevezys	Lithuania
FK Kauno Zalgiris	Lithuania
FK Riteriai	Lithuania
DFK Dainava Alytus	Lithuania
FC Hegelmann Litauen	Lithuania
FK Banga Gargzdai	Lithuania
FC Dziugas Telsiai	Lithuania
FK Nevezis Kedainiai	Lithuania
The New Saints	Wales
Connah's Quay Nomads	Wales
Barry Town United	Wales
Bala Town	Wales
Penybont FC	Wales
Cardiff Metropolitan University	Wales
Newtown AFC	Wales
Caernarfon Town	Wales
Flint Town United	Wales
Haverfordwest County	Wales
Aberystwyth Town	Wales
Cefn Druids	Wales
Dinamo Tbilisi	Georgia
Dinamo Batumi	Georgia
Torpedo Kutaisi	Georgia
FC Samtredia	Georgia
FC Saburtalo	Georgia
FC Dila Gori	Georgia
FC Locomotive Tbilisi	Georgia
FC Telavi	Georgia
Shukura Kobuleti	Georgia
FC Samgurali Tskaltubo	Georgia
HB Tórshavn	Faroe Islands
KÍ Klaksvík	Faroe Islands
B36 Tórshavn	Faroe Islands
NSÍ Runavík	Faroe Islands
TB Tvøroyri	Faroe Islands
EB/Streymur	Faroe Islands
ÍF Fuglafjördur	Faroe Islands
07 Vestur	Faroe Islands
Víkingur Gøta	Faroe Islands
B68 Toftir	Faroe Islands
Hibernians FC	Malta
Hamrun Spartans	Malta
Gzira United FC	Malta
Valletta FC	Malta
Sliema Wanderers	Malta
Birkirkara FC	Malta
Sirens FC	Malta
Gudja United FC	Malta
Balzan FC	Malta
Mosta FC	Malta
Santa Lucia FC	Malta
Floriana FC	Malta
Tarxien Rainbows	Malta
Zejtun Corinthians FC	Malta
Lija Athletic FC	Malta
Senglea Athletic FC	Malta
FC Ararat-Armenia	Armenia
Alashkert Yerevan FC	Armenia
FC Pyunik Yerevan	Armenia
FC Noah Yerevan	Armenia
FC Urartu Yerevan	Armenia
FC Shirak Gyumri	Armenia
FC Ararat Yerevan	Armenia
FC Lori Vanadzor	Armenia
FC Van	Armenia
Gandzasar Kapan	Armenia
Qarabağ FK	Azerbaijan
Neftchi Baku	Azerbaijan
Zira FC	Azerbaijan
FK Keshla	Azerbaijan
Sabah FK	Azerbaijan
Sumgayit PFC	Azerbaijan
FK Qabala	Azerbaijan
FK Sabail	Azerbaijan
FC Sheriff Tiraspol	Moldova
FC Petrocub Hincesti	Moldova
FC Sfîntul Gheorghe Suruceni	Moldova
FC Milsami Orhei	Moldova
FC Dinamo-Auto Tiraspol	Moldova
Dacia Buiucani	Moldova
FC Zimbru Chisinau	Moldova
CSF Speranta Nisporeni (- 2021)	Moldova
FC Floresti	Moldova
CS Codru Lozova (- 2021)	Moldova
FC Astana	Kazakhstan
Kairat Almaty	Kazakhstan
Tobol Kostanay	Kazakhstan
Ordabasy Shymkent	Kazakhstan
FK Aktobe	Kazakhstan
Kaysar Kyzylorda	Kazakhstan
Shakhter Karaganda	Kazakhstan
Qyzyljar Petropavlovsk	Kazakhstan
FK Taraz	Kazakhstan
FK Atyrau	Kazakhstan
Kaspiy Aktau	Kazakhstan
FK Turan	Kazakhstan
Akzhayik Uralsk	Kazakhstan
Zhetysu Taldykorgan	Kazakhstan
Shkendija Tetovo	Macedonia
FC Shkupi	Macedonia
Rabotnicki Skopje	Macedonia
Akademija Pandev	Macedonia
Makedonija Gjorce Petrov	Macedonia
Sileks Kratovo	Macedonia
Vardar Skopje	Macedonia
Borec Veles	Macedonia
Pelister Bitola	Macedonia
Struga Trim & Lum	Macedonia
Renova Dzepciste	Macedonia
Belasica Strumica	Macedonia
FC Prishtina	Kosovo
FC Llapi	Kosovo
KF Ballkani	Kosovo
FC Drita Gjilan	Kosovo
SC Gjilani	Kosovo
KF Feronikeli Drenas	Kosovo
KF Trepca 89	Kosovo
KF Drenica	Kosovo
KF Arbëria	Kosovo
FC Besa Pejë	Kosovo
Buducnost Podgorica	Montenegro
FK Sutjeska Niksic	Montenegro
FK Iskra Danilovgrad	Montenegro
FK Podgorica	Montenegro
FK Decic Tuzi	Montenegro
Rudar Pljevlja	Montenegro
FK Zeta Golubovac	Montenegro
OFK Petrovac	Montenegro
OFK Titograd	Montenegro
FK Jezero	Montenegro
Europa FC	Gibraltar
Lincoln Red Imps FC	Gibraltar
St Joseph's FC	Gibraltar
Lynx FC	Gibraltar
Mons Calpe SC	Gibraltar
Glacis United	Gibraltar
Europa Point FC	Gibraltar
FC Bruno's Magpies	Gibraltar
Lions Gibraltar FC	Gibraltar
Manchester 62 FC	Gibraltar
FC College 1975	Gibraltar
La Fiorita 1967	San Marino
Tre Fiori FC	San Marino
SP Tre Penne	San Marino
SS Folgore/Falciano	San Marino
AC Libertas	San Marino
SS Virtus	San Marino
SS Pennarossa	San Marino
SS Murata	San Marino
AC Juvenes-Dogana	San Marino
SS San Giovanni	San Marino
FC Fiorentino	San Marino
FC Domagnano	San Marino
SC Faetano	San Marino
SP Cailungo	San Marino
SS Cosmos	San Marino
Inter Club d'Escaldes	Andorra
FC Santa Coloma	Andorra
Atlètic Club d'Escaldes	Andorra
UE Engordany	Andorra
UE Santa Coloma	Andorra
UE Sant Julia	Andorra
Club Esportiu Carroi	Andorra
Penya Encarnada d'Andorra	Andorra
